1111111111
1000000001
0000000001
1000X00001
1111111111
