111111111111
100000000001
100000X00001
100000000001
111111111111


