01111100
01111100
01111110
00011000



01110001
00100001
