011111111111111111111110
100000000000000000000001
100000000000000000000001
100000000000000000000001
100001111100001111100001
100001000100001000100001
100001000100001000100001
100001111100001111100X01
100000000000000000000001
100000000000000000000001
100000000000000000000001
011111111111111111111110
