0111111111111110
1000000000000001
1000000000000001
1001111001111001
1001000000001001
1001011111101001
1001011111101001
1001011111101001
1001000000001001
1001111001111001
1000000000000001
0111111111111110
